##########
#    &   #
#        #
#        #
#        #
#        #
#        #
#        #
#   @    #
##########